1111111111111111
1P000000C0000001
1001110001110001
1001010001010001
100111000111M001
1C000000000000E1
1111111111111111